+-----------------------------+-----+--------------+--+-----+-----+-----+-----+--+--+--------------+
| $ $ $ $ $ $ $ $ $ $ $ $ $ $ .     | $  $  $  $  $.  |     |     |     |     .$ |$ |$  $  $  $  $ |
|  $ $ $ $ $ $ $ $ $ $ $ $ $  +  +  |  +-----+  +  +  |  +  |  +  +  +  +  +  +  +  +-----+  +--+  |
| $ $ $ $ $ $ $ $ $ $ $ $ $ $ |  |  |$ |$  $  $ |$ |  |  |  |  |     |     |  | $  $  $  $  $  $| $|
|  $ $ $ $ $ $ $ $ $ $ $ $ $  |  |  |  |  +--+  |  |  +  |  |  +-----+-----+  |..+--------------+..+
| $ $ $ $ $ $ $ $ $ $ $ $ $ $ |  |  | $| $  $| $| $|     |  |  . $  $  $  $|  |  |                 |
|  $ $ $ $ $ $ $ $ $ $ $ $ $  |  |  |  |  +  +  |  +-----+  |  +  +--+  +  |  +  |  +-----------+..+
| $ $ $ $ $ $ $ $ $ $ $ $ $ $ |  |  |$ |$ |$  $ |$ |        |  |$ |$ |$ |$ |     |  |$  $  $  $  $ |
|  $ $ $ $ $ $ $ $ $ $ $ $ $  |  |  |  |  +--+  |  |  +-----+  |  |  |  |  |  +  |  +  +  +-----+  |
| $ $ $ $ $ $ $ $ $ $ $ $ $ $ |  |  | $| $  $  $| $|  |        | $| $| $| $|  |  |  . $| $  $  $| $|
|  $ $ $ $ $ $ $ $ $ $ $ $ $  |  |  +  +  +-----+  |  |  +-----+  +  +--+  |  |  +  +  |  +--+  |  |
| $ $ $ $ $ $ $ $ $ $ $ $ $ $ |  |  .$  $  $  $  $ |  |  |     .$  $  $  $ |  |     |$ |$  $  $ |$ |
+..+--------------------------+  +--+-----------+..+  +  +  +-----------+..+  +-----+  +-----+  +  |
|                                                  |                                . $  $  $  $  $|
+--------+..+--+--------------------------------+  +--+--------------+..+  +  +-----+..+-----------+
|           |$ |$  $   $.                          |  .   $  $   $  $   |  |                       |
|  +--+-----+  +  +  $  +-----+-----------------+  |  +$ +--+  +-----+ $|  +--------------------+..+
|  .$ |$  $  $  $ |$   $|     |  . $  $  $  $  $|  |  |   $  $ | $  $   |  | $  $  $  $  $  $  $|  |
|  +  |  +--------+--+..+  +  |  +  +--------+  |  |  |$ +-----+  +--+ $|  |  +-----------+  +  |  |
|  |$ |$  $  $  $  $ |  |  |  |  |$   $   $  |$ |  |  |   $  $   $  $   |  |$ |$  $  $  $  $ |$ |  |
|  |  +-----------+  |  +  |  +  |  +--+  +  |  |  |  +--------+..+-----+  |  +  +-----------+  |  |
|  |$  $  $  $  $  $ |     |     | $  $| $| $| $|  |           |        |  | $  $  $  $  $  $  $|  |
|  +--------------+..+-----+--+..+  +  +  |  +  |  +--------+  +-----+  |  |..+--------------+..|  |
|                 |              |$ |$  $ |$  $ |              |        |  |                 |  |  |
+--------+-----+  +-----------+  |  +--------+  +  +-----------+  +-----+  +--------------+  |  +  |
| $ $ | $|  .  |  .   $   $   |  | $  $  $  $  $.              |                             |     |
|  +  +  |$ +  |  +  +  +--+  |  +--+-----------+..+--------+  +-----------------------+..+--------+
|$ | $   |  |  |  | $| $|$ |$ |     |              |                                   |     $     |
|  +--+ $| $|  |  |  +--+  +  |  +  |  +--------+  |  +--+..+-----------+--+--------+  |  +  +--+  |
| $  $|  |  |  |  |   $   $   |  |  |  |$      $|  |  |                 .  |    $   |  |$ |$ | $| $|
+--+  |$ +$ |  |  +-----+--+..+  |  +  |  +--+  |  |  |  +..+-----------+  +  +--+  |  |  +--+  +  |
|$  $ | $   |  |        |        |     | $   |$ |  |  |  |    $     $   |  .$   $| $|  |     $     |
+..+--+-----+  +-----+  |  +-----+--+  |  + $+  +  +  |  |  +-----+  +  |  +  +--+  |  +--------+..+
|  |                    |  .   $    |  |$ |    $.     |  |  |$   $| $|  |  | $| $   |  |           |
|  +  +--+..+-----+--+  |  +  +--+  |  |  +--------+--+  | $| $+--+$ | $|  +--+..+--+  +  +-----+  |
|     |   $ |  $  |     |  |$ |$$  $|  | $  $  $.  |     |  |$  $   $|  |           |     |        |
+-----+ $+  +$ + $|  +--+  |  +--+  +  +--------+  |  +  |  +--------+  +--------+  +-----+  +-----+
|  $  |  | $  $|$ |  |     |    $   .  |        |  |  |  |       $               |        |        |
|  + $+$ |  +--+  |  +  +--+--+-----+  +  +  +  |  +  |  +--------------+-----+  +-----+..+--+--+  |
|  |$   $| $   $  |     |     |     |     |  |  |     |                 |     |        |     |     |
|  +-----+--------+-----+  +  +  +  +-----+  |  +-----+  +-----------+..+  +  +-----+..+..+  +  +  |
|                          |     |           |           | $ $ $ $ $ .     |              |     | XO
+--------------------------+-----+-----------+-----------+-----------+-----+--------------+-----+--+