+-----------------------------------------------------------------------------+--------------------+
|X  $  $  $  $  $  $  $  $  $  $  $  $  $  $  $  $  $  $  $  $  $  $  $  $  $ |                    |
|  +-----------------------------------------------------------------------+  +-----------------+  |
| $|                                                                                            |  |
|  |  +--------------------------------------+  +--------------------------------------------+  |  |
|$ |  |  $  $  $  $  $  $  $  $  $  $  $  $  $  $  $  $  $  $  $  $  $  $  $  $  $  $  $  $  |  |  |
|  |  |$ +--------+-----------------------------------------+  +--------------------------+  |  |  |
| $|  |  |        |                                            |                          |  |  |  |
|  |  | $|  +-----+  +--------------------------------+--------+-----------------------+  |  |  |  |
|$ |  |  |  |                                         | $  $  $  $  $  $  $  $  $  $  $|  |  |  |  |
|  |  |$ |  |  +--------------------------------------+  +--------------------------+  |  |  |  |  |
| $|  |  |  |  |$  $  $  $  $  $  $  $  $  $  $  $  $  $                            |$ |  |  |  |  |
|  |  | $|  |  |  +--------------------------------------+  +--------------------+  |  +$ |  |  |  |
|$ |  |  |  |  | $|                    |                 |                       |  | $   |  |  |  |
|  |  |$ |  |  |  |  +-----------------+  +-----------+  +--------------------+  +--+--+ $|  |  |  |
| $|  |  |  |  |$ |  |                    | $  $  $  $                        |  |$  $ |  |  |  |  |
|  |  | $|  |  |  |  |  +-----------------+  +-----------------------------+  |  |  +  |$ |  |  |  |
|$ |  |  |  |  | $|  |  |$  $  $  $  $  $  $  $  $  $  $  $  $  $  $  $  $ |  +  | $| $|  |  |  |  |
|  |  |$ |  |  |  |  |  |  +--------------------+--+--------------------+  |     |  |  | $|  |  |  |
| $+--+  |     |$ |  |  | $|  $ $ $ $ $ $ $ $ $ |OO| $ $ $ $ $ $ $ $ $  | $+--+--+$ |$ |  |  |  |  |
|     | $|  +--+  |  |  +--+ $ $ $ $ $ $ $ $ $  +..+  $ $ $ $ $ $ $ $ $ |  |  |     |  |$ |  |  |  |
|  +  |  |  |  | $|  |     |  $ $ $ $ $ $ $ $ $      $ $ $ $ $ $ $ $ $  |$ |  |  + $| $|  |  |  |  |
|  |  |$ |  |  |  |  +--+  | $ $ $ $ $ $ $ $ $  +  +  $ $ $ $ $ $ $ $ $ |  |  |  |  |  | $|  |  |  |
|  |  |  |  |  |$ |     |  |  $ $ $ $ $ $ $ $ $ |  | $ $ $ $ $ $ $ $ $  | $|  |  |$ |$ |  |  |  |  |
|  |  +--+  |  |  |  +  |  +--------------------+  +--------------------+  |  |  |  |  |$ |  |  |  |
|  |  |$    |  | $|  |  |                          |$  $  $  $  $  $  $  $ |  |  | $| $|  |  |  |  |
|  |  |  +--+  |  |  |  +--------------------------+-----------------------+  |  |  |  | $|  |  |  |
|  |  | $|  |  |$ |  |                                                        |  |$ |$ |  |  |  |  |
|  |  |  |  |  |  |  +--------------------------------------------------------+  |  |  +$ +--+--+  |
|  |  |$ |  |  | $|                                                              | $| $      |     |
|  |  |  |  |  |  +--------------------------------------------------------------+  |  +--+  |  +  |
|  |  | $|  |  |$  $  $  $  $  $  $  $  $  $  $  $  $  $  $  $  $  $  $  $  $  $  $ |  | $|  |  |  |
|  |  |  |  |  +--------------------------------------------+-----------------------+  |  |  |  |  |
|  |  |$ |  |                                               |                          |$ |  |  |  |
|  |  |  |  +--------------+  +--------------------------+  +--------------------------+  |  |  |  |
|  |  | $|                                               |                   $  $  $  $  $|  |  |  |
|  |  |  +-----------------+  +-----------------+--------+--------------+  +--------------+  |  |  |
|  |  |$  $  $  $  $  $  $ |                    |                                            |  |  |
|  |  +-----------------+  +-----------------+  +--------------------------------------------+  |  |
|  |                    |                       |                                               |  |
|  +--------------------+-----------------------+-----------------------------------------------+  |
|                                                                                                  |
+--------------------------------------------------------------------------------------------------+