+--------------------------------------------------------------------------------------------------+
|X                                                                                                 |
|     +--+-----------------------------------------------------------------------------+-----+     |
|     .  |  $ $ $ $ $ $ $ $ $ $ $ $ $ $ $ $ $ $ $ $ $ $ $ $ $ $ $ $ $ $ $ $ $ $ $ $ $  +     .     |
|  +..+  | $ $ $ $ $ $ $ $ $ $ $ $ $ $ $ $ $ $ $ $ $ $ $ $ $ $ $ $ $ $ $ $ $ $ $ $ $ $ .     +..+  |
|  |     |  $ $ $ $ $ $ $ $ $ $ $ $ $ $ $ $ $ $ $ $ $ $ $ $ $ $ $ $ $ $ $ $ $ $ $ $ $  +        |  |
|  +-+.+-+-----------------------------------------------------------------------------+..+-----+  |
|  |     |                                                                                |     |  |
|  |  $  |  +------------+  +--------+..+  +------------+  +-----------+  +------------+  |  $  |  |
|  | $ $ |  | $ $ $ $ $  |  | $ $ $ $ $ |  .  $ $ $ $ $ |  |  $ $ $ $  |  | $ $ $ $ $  |  | $ $ |  |
|  |  $  |  |  $ $ $ $ $ |  |  $ $ $ $  |  + $ $ $ $ $  |  | $ $ $ $ $ |  |  $ $ $ $ $ |  |  $  |  |
|  | $ $ |  | $ $ $ $ $  +  | $ $ $ $ $ |  |  $ $ $ $ $ |  |  $ $ $ $  |  | $ $ $ $ $  +  | $ $ |  |
|  |  $  |  |  $ $ $ $ $ .  |  $ $ $ $  |  | $ $ $ $ $  |  | $ $ $ $ $ |  |  $ $ $ $ $ .  |  $  |  |
|  | $ $ |  +------------+  +-----------+  +------------+  +..+--------+  +------------+  | $ $ |  |
|  |  $  |                                                                                |  $  |  |
|  | $ $ |  +------------+  +------------------------------------------+  +------------+  | $ $ |  |
|  |  $  |  |  $ $ $ $ $ |  |  $ $ $ $ $ $ $ $ $ $ $ $ $ $ $ $ $ $ $ $ |  |  $ $ $ $ $ |  |  $  |  |
|  | $ $ |  | $ $ $ $ $  |  | $ $ $ $ $ $ $ $ $ $ $ $ $ $ $ $ $ $ $ $  |  | $ $ $ $ $  |  | $ $ |  |
|  |  $  |  |  $ $ $ $ $ |  |  $ $ $ $ $ $ $ $ $ $ $ $ $ $ $ $ $ $ $ $ |  |  $ $ $ $ $ |  |  $  |  |
|  | $ $ |  | $ $ $ $ $  |  | $ $ $ $ $ $ $ $ $ $ $ $ $ $ $ $ $ $ $ $  |  | $ $ $ $ $  |  | $ $ |  |
|  |  $  |  +..+---------+  |  $ $ $ $ $ $ $ $ $ $ $ $ $ $ $ $ $ $ $ $ |  +..+---------+  |  $  |  |
|  | $ $ |                  | $ $ $ $ $ $ $ $ $ $ $ $ $ $ $ $ $ $ $ $  |                  | $ $ |  |
|  |  $  |  +------------+  |  $ $ $ $ $ $ $ $ $ $ $ $ $ $ $ $ $ $ $ $ |  +------------+  |  $  |  |
|  | $ $ |  . $ $ $ $ $  |  | $ $ $ $ $ $ $ $ $ $ $ $ $ $ $ $ $ $ $ $  |  . $ $ $ $ $  |  | $ $ |  |
|  |  $  |  +  $ $ $ $ $ |  |  $ $ $ $ $ $ $ $ $ $ $ $ $ $ $ $ $ $ $ $ |  +  $ $ $ $ $ |  |  $  |  |
|  | $ $ |  | $ $ $ $ $  |  | $ $ $ $ $ $ $ $ $ $ $ $ $ $ $ $ $ $ $ $  |  | $ $ $ $ $  |  | $ $ |  |
|  |  $  |  |  $ $ $ $ $ |  |  $ $ $ $ $ $ $ $ $ $ $ $ $ $ $ $ $ $ $ $ |  |  $ $ $ $ $ |  |  $  |  |
|  | $ $ |  +------------+  +-----------+..+------------+..+-----------+  +------------+  | $ $ |  |
|  |  $  |                                                                                |  $  |  |
|  | $ $ |  +---------+..+  +-----------+  +------------+  +-----------+  +---------+..+  | $ $ |  |
|  |  $  |  |  $ $ $ $ $ |  .  $ $ $ $  |  | $ $ $ $ $  |  | $ $ $ $ $ |  |  $ $ $ $ $ |  |  $  |  |
|  | $ $ |  | $ $ $ $ $  |  + $ $ $ $ $ |  |  $ $ $ $ $ |  |  $ $ $ $  |  | $ $ $ $ $  |  | $ $ |  |
|  |  $  |  |  $ $ $ $ $ |  |  $ $ $ $  |  | $ $ $ $ $  |  | $ $ $ $ $ +  |  $ $ $ $ $ |  |  $  |  |
|  | $ $ |  | $ $ $ $ $  |  | $ $ $ $ $ |  |  $ $ $ $ $ |  |  $ $ $ $  .  | $ $ $ $ $  |  | $ $ |  |
|  |  $  |  +------------+  +-----------+  +..+---------+  +-----------+  +------------+  |  $  |  |
|  |     |                                                                                |     |  |
|  +-----+..+-----------------------------------------------------------------------------+-+.+-+  |
|  |        +  $ $ $ $ $ $ $ $ $ $ $ $ $ $ $ $ $ $ $ $ $ $ $ $ $ $ $ $ $ $ $ $ $ $ $ $ $  |     |  |
|  +..+     . $ $ $ $ $ $ $ $ $ $ $ $ $ $ $ $ $ $ $ $ $ $ $ $ $ $ $ $ $ $ $ $ $ $ $ $ $ $ |  +..+  |
|     .     +  $ $ $ $ $ $ $ $ $ $ $ $ $ $ $ $ $ $ $ $ $ $ $ $ $ $ $ $ $ $ $ $ $ $ $ $ $  |  .     |
|     +-----+-----------------------------------------------------------------------------+--+     |
|                                                                                                  O
+--------------------------------------------------------------------------------------------------+