+--+--------------------+
|X |                    |
|  +-----------------+  |
|        $              |
|  +--------+..+--+  +--+
|  | $         |  |  | $|
|  |  +--+  +--+  |  |  |
|  |  |  |  |  |  |  |  |
|  |  +  +--+  +  +--+  |
|  |         $       .  |
|  +-----------------+  +
|                    | $O
+--------------------+--+