+---------+--+----------+
|         . X. $        |
|  +------+--+-------+  |
| $.                 |  |
|  +--------------+..|  |
|  |              .  |  |
|  |  +-----------+  |  |
|  | $|             $|  |
|  |  +------+----+..+  |
|  |         |       .  |
|  +------+  +-------+  |
|         | $|          |
+---------+OO+----------+