+-----------------------+
|$                      |
|  +--+  +-----+  +  +  |
|  |     |        |  |  |
|  |  +--+..+-----+  |  |
|  |$ |$$. X.        |  |
|  |  +--+..+  +-----+  |
|  |     |  |$ |$$$$$|  |
|  +--+  +  +--+.---.+  |
|     |     |     $     |
|  +--+-+.+-+  +--------+
|        $  |           O
+-----------+-----------+