+--+--+--------------------------------------------+
O  |X |     .                                 $    |
+  |  +  +--+  +--------------------------------+  |
|  |     |    $|        $                          |
|  +--+..+  +--+  +--+-----+-----+--+--------+  +--+
|     |$ |  |       $|     |$    | $.        |  |  |
+--+  |  |  |  +--+--+  +  +--+  |  |  +  +  |  |  |
| $   |  |  |     |$ |  |  |     |  |  |  | $|  |  |
|  +--+  |  +--+..+  +  |  +  +  |  |  |  +--+  |  |
|  |     |        .     |     |  |  |  |        |  |
|  |  +  +--------+-----+-----+  +  |  +--------+  |
|  |  |                 |        .$$|              |
|  |$ +-----------------+--------+..+--------------+
|  |                             |                 |
|  +--+--+  +-----+  +--------+  +--+  +-----+  +--+
|   $ |     |    $|  |              |    $   |  |  |
+--+  |  +  |  +--+  +  +--------+  +-----+  |  |  |
|  |  |  |  |     .     |        |        |  |  |  |
|  |  |  |  +-----+-----+  +  +  +--------+  |  |  |
|  |  |  |        |   $    |  |  |        |  |  |  |
|  |  +--+--+--+  +--------+  |  +  +  +--+--+  |  |
|  |        |$    |           |     |  .$$.  |  |  |
|  +-----+  +-----+  +--------+--------+--+  +  +  |
|  $                           $          |        |
+-----------------------------------------+--------+