+-----+-----+-----+-----+-----+-----+-----+-----+--+
|  $  |  $  |  $  |  $  |  $  |  $  |  $  |  $  |  O
|  +  |  +  |  +  |  +  |  +  |  +  |  +  |  +  |  |
|  |  |  |  |  |  |  |  |  |  |  |  |  |  |  |  |  |
|  |  +  |  +  |  +  |  +  |  +  |  +  |  +  |  +  |
|  |     |     |     |     |     |     |     |     |
+..+-----+-----+-----+-----+-----+--+--+-----+-----+
|  |        $         $ $ $ $ $ $   |    $    $    |
|  |$ +-----------+..+-----------+..|  +--------+  |
|  |  |     $     |           $  |$ |  |  .  .  |  |
|  | $|  +-----+  +-----------+  |  |  |$ +  + $|  |
|  |  |  |     |  |           $  | $|$ |  |  |  | $|
|  |$ |  |  +  |  |  +-----------+  |  | $|  |$ |  |
|  |  |  |  |  |  |  |        $     |  |  |  |  |  |
|  + $|  |  |  +  +  |  +-----------+  |$ |  | $+  |
|     |  |  | $.  .$ |   $    $    $   |  |  |     |
+-----+  |  +--------+-----------------+ $|  +-----+
|  $  $  |  $        $        $        $  |  $  $  |
+..+-----+--------+-----+-----+-----+-----+-----+..+
|  |     |  .  .  |     |     |     |     |     |  |
|  |  +  |  +  +  |  +  |  +  |  +  |  +  |  +  |  |
|  |  |  |  |  |  |  |  |  |  |  |  |  |  |  |  |  |
|  +  |  +  |  |  +  |  +  |  +  |  +  |  +  |  +  |
|  $  |  $  |X |  $  |  $  |  $  |  $  |  $  |  $  |
+-----+-----+--+-----+-----+-----+-----+-----+-----+