+--------------+-----+-----------+-----+-----------+
|              |     | $ $ $ $ $ .     | $ $ $ $ $ |
|  +--------+  |  +  +  $ $ $ $  |  +  |  $ $ $ $  |
|           |  |  |  . $ $ $ $ $ |  |  | $ $ $ $ $ |
+--------+..+  |  +--+--+--------+  |  +..+-----+..+
|  $ $ $ $  |  |                    |              |
| $ $ $ $ $ |  +-----+  +-----------+-----------+  |
|  $ $ $ $  |        .  .                          |
| $ $ $ $ $ +--------+  +--------------+--------+..+
|  $ $ $ $  |$  $  $ .  .              | $ $ $ $ $ |
+..+--+-----+--------+--+..+--------+  |  $ $ $ $  |
|     | $ $ |           | $ $ $ $ $ |  | $ $ $ $ $ |
|  |  |  $  |  +-----+  |  $ $ $ $  |  |  $ $ $ $  |
|  |  | $ $ |  |        | $ $ $ $ $ |  | $ $ $ $ $ |
|  |  +..+..|  |  +-----+..+-----+..+  |..+--------+
|  |        |  |  .                 |  |           |
|  +--+..+--+  |  +--------------+--+..+--------+  |
|     |        |  |  $  $  $  $  .              |  |
+--+  |  +-----+  +--------------+  +---------..+  |
|  .  |  |                       |  . $ $ $ $ $ |  |
|  +--+  |  +-----+-----------+  |  |  $ $ $ $  |  |
|X .     |  |     |$  $  $ .     |  | $ $ $ $ $ |  |
|  +-----+..+  +  +--------+  +--+  |  $ $ $ $  |  |
|  .           |                    | $ $ $ $ $ |  O
+--+-----------+--------------------+-----------+--+